    +---+---+---+
    | ~ | ~ | ~ |
    +---+---+---+
    | ~ | X | ^ |
    +---+---+---+
    | ~ | ~ | ~ |
    +---+---+---+